40 40
7 4 5 7 2 1 1 1 1 3 3 3 0 0 0 0 0 0 2 1 1 1 1 2 0 0 0 0 0 0 0 0 0 0 0 0 3 3 3 0
2 4 7 7 2 1 2 2 3 3 3 3 0 0 0 0 0 0 2 2 2 2 2 2 0 0 0 0 0 0 0 0 0 0 0 0 3 3 3 3
5 7 7 0 2 1 2 0 3 3 3 3 0 0 0 0 0 0 0 0 0 0 0 0 0 0 0 0 0 0 0 0 0 0 0 0 3 3 3 3
7 7 0 0 2 1 2 0 3 3 3 3 0 0 0 0 0 0 0 0 0 0 0 0 0 0 0 0 0 0 0 0 0 0 0 0 3 3 3 3
0 0 0 0 2 2 2 0 0 0 0 0 0 0 0 2 2 2 2 2 2 3 3 3 3 0 0 0 0 0 0 0 0 0 0 2 2 2 2 0
0 0 0 0 0 0 2 2 2 0 2 2 2 0 3 3 1 1 1 1 2 3 3 3 3 0 0 0 0 0 0 0 0 0 0 2 1 1 2 0
3 3 3 3 0 0 2 1 6 6 6 1 2 0 3 3 3 3 2 1 2 3 3 3 3 0 0 0 0 0 0 0 0 0 0 2 1 2 2 0
3 3 3 3 2 2 2 1 6 4 6 1 2 2 3 3 3 3 2 1 2 3 3 3 3 0 0 0 2 2 2 0 0 0 0 2 2 2 7 7
3 3 3 3 2 1 1 1 4 4 4 1 1 1 3 3 3 3 2 1 2 0 0 0 0 0 0 0 2 1 2 0 0 0 0 0 0 0 7 5
3 3 3 3 2 2 6 4 4 4 4 4 6 2 2 0 0 0 2 1 2 0 0 0 0 0 2 2 2 1 2 2 2 0 0 0 0 0 7 5
2 2 0 0 2 1 1 1 4 4 4 1 1 1 2 0 0 0 2 1 2 0 0 0 0 0 2 1 1 1 1 1 2 0 0 0 0 0 7 5
1 2 0 0 2 2 2 1 4 4 4 1 2 2 2 0 0 0 2 1 2 0 0 0 0 0 2 2 2 2 2 2 2 0 0 0 0 0 7 5
1 2 0 0 0 0 2 1 6 4 6 1 2 0 0 0 0 0 2 2 2 0 0 0 0 0 0 0 0 0 0 0 0 0 2 2 2 0 7 7
1 2 2 2 2 0 2 2 6 6 6 2 2 0 0 0 0 0 0 0 0 0 0 0 0 0 0 0 3 3 3 3 0 0 2 1 2 0 0 0
1 1 1 1 2 0 0 0 0 0 0 0 0 0 0 0 0 0 0 0 0 0 0 0 0 0 0 0 3 3 3 3 0 0 2 1 2 0 0 0
2 2 2 2 2 0 0 0 0 0 0 0 0 2 2 2 0 0 0 0 0 0 0 0 0 0 0 0 3 3 3 3 0 0 2 1 2 0 0 0
0 0 0 0 0 0 0 3 3 3 3 0 0 2 1 2 0 0 7 7 7 2 0 2 2 2 0 0 3 3 3 3 0 0 2 1 2 0 0 0
0 0 0 0 0 0 0 3 3 3 3 0 0 2 1 2 0 7 7 5 1 2 0 2 1 2 0 0 0 0 0 0 0 0 2 2 2 0 0 0
0 0 0 0 0 0 0 3 3 3 3 2 2 2 1 2 7 7 5 5 1 2 0 2 1 6 6 0 0 0 0 0 0 0 0 0 0 0 0 0
0 0 0 0 0 0 0 3 3 3 3 1 1 1 1 2 7 5 5 5 1 2 0 2 1 4 6 6 0 0 0 0 0 0 0 0 0 0 0 0
0 0 0 0 0 0 0 0 0 0 2 2 2 2 2 2 7 1 1 1 1 2 0 2 1 4 4 6 2 2 0 0 0 0 0 0 0 0 0 0
0 2 2 2 0 0 0 0 0 0 0 0 0 0 0 0 3 3 3 3 1 2 0 2 1 1 1 1 1 2 0 0 0 0 2 2 2 0 0 0
0 2 1 2 0 0 0 0 0 0 0 0 0 0 0 0 3 3 3 3 1 2 0 2 1 3 3 3 3 2 0 0 0 0 2 1 2 0 0 0
0 2 1 2 0 7 7 7 2 0 0 0 0 0 0 0 3 3 3 3 1 2 0 2 1 3 3 3 3 0 0 0 2 2 2 1 2 0 0 0
0 2 1 2 0 7 5 1 2 0 0 0 0 0 0 0 3 3 3 3 2 2 0 2 1 3 3 3 3 0 0 0 2 1 1 1 2 0 0 0
0 2 1 2 0 7 5 1 2 0 0 0 0 0 0 0 0 0 0 0 0 0 0 2 1 3 3 3 3 2 0 0 7 5 5 1 2 0 0 0
0 2 1 2 0 7 5 1 2 0 0 3 3 3 3 0 0 0 0 0 0 0 0 2 2 2 0 2 1 2 0 0 7 7 5 1 2 0 0 0
0 2 1 2 0 7 5 1 2 0 0 3 3 3 3 0 0 0 2 2 2 0 0 0 0 0 0 2 1 2 0 0 0 7 7 2 2 0 0 0
0 2 1 2 0 7 5 1 2 0 0 3 3 3 3 0 0 0 2 1 2 0 0 0 0 0 0 2 1 2 0 0 0 0 0 0 0 0 0 0
0 2 1 2 0 7 5 1 2 2 2 3 3 3 3 0 0 0 2 1 2 0 0 0 0 0 0 2 2 2 0 0 0 0 0 0 0 0 0 0
0 2 1 2 0 7 5 1 1 1 1 1 1 2 0 0 0 0 2 2 2 0 0 0 2 2 2 2 2 2 0 0 0 0 3 3 3 3 0 0
0 2 1 2 0 7 7 7 2 2 2 2 2 2 0 0 0 0 0 0 0 0 0 0 2 1 1 1 1 2 0 0 0 0 3 3 3 3 0 0
0 2 1 2 2 2 0 0 0 0 0 0 0 0 0 0 0 0 0 0 0 0 0 3 3 3 3 2 1 2 0 0 0 0 3 3 3 3 0 0
0 2 1 1 1 2 0 0 0 0 0 0 0 0 0 0 0 0 0 0 0 0 0 3 3 3 3 2 1 2 0 0 0 0 3 3 3 3 0 0
0 2 2 2 1 2 3 3 3 3 0 0 0 0 0 0 0 0 0 0 0 0 0 3 3 3 3 2 1 2 0 0 0 0 0 0 0 0 0 0
0 0 0 2 1 2 3 3 3 3 0 0 0 0 0 0 0 0 0 0 0 0 0 3 3 3 3 2 2 2 0 0 2 2 2 0 0 0 0 0
6 6 0 2 1 2 3 3 3 3 0 0 0 0 0 0 0 0 0 0 0 0 0 0 0 0 0 0 0 0 0 2 2 1 2 0 0 0 7 7
4 6 6 2 2 2 3 3 3 3 0 0 0 2 2 2 2 2 2 2 2 0 0 0 0 0 0 0 0 0 0 2 1 1 2 0 0 7 7 5
4 4 6 6 0 0 0 0 0 0 0 0 0 2 1 1 1 1 1 1 2 0 0 0 0 0 0 0 0 0 0 2 2 2 2 0 7 7 5 5
4 4 4 6 0 0 0 0 0 0 0 0 0 2 2 2 2 2 2 2 2 0 0 0 0 0 0 0 0 0 0 0 0 0 0 0 7 5 5 5
# BASES
3 1000 0 37 3 3
